-	ー
~	〜
.	。
,	、
[	「
]	」
va	ゔぁ
vi	ゔぃ
vu	ゔ
ve	ゔぇ
vo	ゔぉ
kya	きゃ
kyi	きぃ
kyu	きゅ
kye	きぇ
kyo	きょ
qa	きゃ
qi	きい
qu	きゅ
qe	きえ
qo	きょ
gya	ぎゃ
gyi	ぎぃ
gyu	ぎゅ
gye	ぎぇ
gyo	ぎょ
sya	しゃ
syi	しぃ
syu	しゅ
sye	しぇ
syo	しょ
xa	しゃ
xi	しい
xu	しゅ
xe	しぇ
xo	しょ
ja	じゃ
ji	じ
ju	じゅ
je	じぇ
jo	じょ
tya	ちゃ
tyi	ちぃ
tyu	ちゅ
tye	ちぇ
tyo	ちょ
ca	ちゃ
ci	ちい
cu	ちゅ
ce	ちぇ
co	ちょ
dya	ぢゃ
dyi	ぢぃ
dyu	ぢゅ
dye	ぢぇ
dyo	ぢょ
tsa	つぁ
tsi	つぃ
tse	つぇ
tso	つぉ
tla	てゃ
tli	てぃ
tlu	てゅ
tle	てぇ
tlo	てょ
dla	でゃ
dli	でぃ
dlu	でゅ
dle	でぇ
dlo	でょ
nya	にゃ
nyi	にぃ
nyu	にゅ
nye	にぇ
nyo	にょ
hya	ひゃ
hyi	ひぃ
hyu	ひゅ
hye	ひぇ
hyo	ひょ
bya	びゃ
byi	びぃ
byu	びゅ
bye	びぇ
byo	びょ
pya	ぴゃ
pyi	ぴぃ
pyu	ぴゅ
pye	ぴぇ
pyo	ぴょ
fa	ふぁ
fi	ふぃ
fu	ふ
fe	ふぇ
fo	ふぉ
fya	ふゃ
fyu	ふゅ
fyo	ふょ
mya	みゃ
myi	みぃ
myu	みゅ
mye	みぇ
myo	みょ
rya	りゃ
ryi	りぃ
ryu	りゅ
rye	りぇ
ryo	りょ
a	あ
i	い
u	う
wu	う
e	え
o	お
la	ぁ
li	ぃ
lu	ぅ
le	ぇ
lo	ぉ
ye	いぇ
ka	か
ki	き
ku	く
ke	け
ko	こ
ga	が
gi	ぎ
gu	ぐ
ge	げ
go	ご
sa	さ
si	し
su	す
se	せ
so	そ
za	ざ
zi	じ
zu	ず
ze	ぜ
zo	ぞ
ta	た
ti	ち
tu	つ
te	て
to	と
da	だ
di	ぢ
du	づ
de	で
do	ど
na	な
ni	に
nu	ぬ
ne	ね
no	の
ha	は
hi	ひ
hu	ふ
fu	ふ
he	へ
ho	ほ
ba	ば
bi	び
bu	ぶ
be	べ
bo	ぼ
pa	ぱ
pi	ぴ
pu	ぷ
pe	ぺ
po	ぽ
ma	ま
mi	み
mu	む
me	め
mo	も
lya	ゃ
ya	や
yi	ゐ
lyu	ゅ
yu	ゆ
ye	ゑ
lyo	ょ
yo	よ
ra	ら
ri	り
ru	る
re	れ
ro	ろ
lwa	ゎ
wa	わ
wi	うぃ
we	うぇ
wo	を
wla	うぁ
wli	うぃ
wlu	う
wle	うぇ
wlo	うぉ
;	ん
l	っ
ll	っ
vx	ゔぁん
vw	ゔぃん
vq	ゔん
vv	ゔぇん
vc	ゔぉん
kx	かん
kw	きん
kq	くん
kv	けん
kc	こん
sx	さん
sw	しん
sq	すん
sv	せん
sc	そん
tx	たん
tw	ちん
tq	つん
tv	てん
tc	とん
nx	なん
nw	にん
nq	ぬん
nv	ねん
nc	のん
hx	はん
hw	ひん
hq	ふん
hv	へん
hc	ほん
mx	まん
mw	みん
mq	むん
mv	めん
mc	もん
yx	やん
yq	ゆん
yc	よん
rx	らん
rw	りん
rq	るん
rv	れん
rc	ろん
wx	わん
gx	がん
gw	ぎん
gq	ぐん
gv	げん
gc	ごん
zx	ざん
zw	じん
zq	ずん
zv	ぜん
zc	ぞん
dx	だん
dw	ぢん
dq	づん
dv	でん
dc	どん
bx	ばん
bw	びん
bq	ぶん
bv	べん
bc	ぼん
px	ぱん
pw	ぴん
pq	ぷん
pv	ぺん
pc	ぽん
kyx	きゃん
kyw	きいん
kyq	きゅん
kyv	きえん
kyc	きょん
qx	きゃん
qw	きいん
qq	きゅん
qv	きえん
qc	きょん
gyx	ぎゃん
gyw	ぎぃん
gyq	ぎゅん
gyv	ぎぇん
gyc	ぎょん
syx	しゃん
syw	しいん
syq	しゅん
syv	しぇん
syc	しょん
xx	しゃん
xw	しいん
xq	しゅん
xv	しぇん
xc	しょん
jx	じゃん
jw	じぃん
jq	じゅん
jv	じぇん
jc	じょん
cx	ちゃん
cw	ちいん
cq	ちゅん
cv	ちぇん
cc	ちょん
dyx	ぢゃん
dyw	ぢぃん
dyq	ぢゅん
dyv	ぢぇん
dyc	ぢょん
tsx	つぁん
tsw	つぃん
tsv	つぇん
tsc	つぉん
tlx	てゃん
tlw	てぃん
tlq	てゅん
tlv	てぇん
tlc	てょん
dlx	でゃん
dlw	でぃん
dlq	でゅん
dlv	でぇん
dlc	でょん
nyx	にゃん
nyw	にぃん
nyq	にゅん
nyv	にぇん
nyc	にょん
hyx	ひゃん
hyw	ひぃん
hyq	ひゅん
hyv	ひぇん
hyc	ひょん
byx	びゃん
byw	びぃん
byq	びゅん
byv	びぇん
byc	びょん
pyx	ぴゃん
pyw	ぴぃん
pyq	ぴゅん
pyv	ぴぇん
pyc	ぴょん
fx	ふぁん
fw	ふぃん
fq	ふん
fv	ふぇん
fc	ふぉん
myx	みゃん
myw	みぃん
myq	みゅん
myv	みぇん
myc	みょん
ryx	りゃん
ryw	りぃん
ryq	りゅん
ryv	りぇん
ryc	りょん
v:	ゔぁい
v-	ゔぃい
v;	ゔう
v.	ゔぇい
v,	ゔぉう
k:	かい
k-	きい
k;	くう
k.	けい
k,	こう
s:	さい
s-	しい
s;	すう
s.	せい
s,	そう
t:	たい
t-	ちい
t;	つう
t.	てい
t,	とう
n:	ない
n-	にい
n;	ぬう
n.	ねい
n,	のう
h:	はい
h-	ひい
h;	ふう
h.	へい
h,	ほう
m:	まい
m-	みい
m;	むう
m.	めい
m,	もう
y:	やい
y;	ゆう
y,	よう
r:	らい
r-	りい
r;	るう
r.	れい
r,	ろう
w:	わい
g:	がい
g-	ぎい
g;	ぐう
g.	げい
g,	ごう
z:	ざい
z-	じい
z;	ずう
z.	ぜい
z,	ぞう
d:	だい
d-	ぢい
d;	づう
d.	でい
d,	どう
b:	ばい
b-	びい
b;	ぶう
b.	べい
b,	ぼう
p:	ぱい
p-	ぴい
p;	ぷう
p.	ぺい
p,	ぽう
ky:	きゃい
ky-	きち
ky;	きゅう
ky.	きえい
ky,	きょう
q:	きゃい
q-	きち
q;	きゅう
q.	きえい
q,	きょう
gy:	ぎゃい
gy-	ぎち
gy;	ぎゅう
gy.	ぎぇい
gy,	ぎょう
sy:	しゃい
sy-	しち
sy;	しゅう
sy.	しぇい
sy,	しょう
sr:	しゃい
sr-	しち
sr;	しゅう
sr.	しぇい
sr,	しょう
x:	しゃい
x-	しち
x;	しゅう
x.	しぇい
x,	しょう
j:	じゃい
j-	じち
j;	じゅう
j.	じぇい
j,	じょう
c:	ちゃい
c-	ちち
c;	ちゅう
c.	ちぇい
c,	ちょう
dy:	ぢゃい
dy-	ぢち
dy;	ぢゅう
dy.	ぢぇい
dy,	ぢょう
ts:	つぁい
ts-	つち
ts.	つぇい
ts,	つぉう
tr:	てゃい
tr-	てぃい
tr;	てゅう
tr.	てぇい
tr,	てょう
dr:	でゃい
dr-	でぃい
dr;	でゅう
dr.	でぇい
dr,	でょう
ny:	にゃい
ny-	にち
ny;	にゅう
ny.	にぇい
ny,	にょう
hy:	ひゃい
hy-	ひち
hy;	ひゅう
hy.	ひぇい
hy,	ひょう
by:	びゃい
by-	びち
by;	びゅう
by.	びぇい
by,	びょう
py:	ぴゃい
py-	ぴち
py;	ぴゅう
py.	ぴぇい
py,	ぴょう
f:	ふぁい
f-	ふぃい
f;	ふう
f.	ふぇい
f,	ふぉう
my:	みゃい
my-	みち
my;	みゅう
my.	みぇい
my,	みょう
ry:	りゃい
ry-	りち
ry;	りゅう
ry.	りぇい
ry,	りょう
vk	ゔぁっ
vn	ゔぃっ
vg	ゔっ
vt	ゔぇっ
vs	ゔぉっ
kk	かっ
kn	きっ
kg	くっ
kt	けっ
ks	こっ
sk	さっ
sn	しっ
sg	すっ
st	せっ
ss	そっ
tk	たっ
tn	ちっ
tg	つっ
tt	てっ
ts	とっ
nk	なっ
nn	にっ
ng	ぬっ
nt	ねっ
ns	のっ
hk	はっ
hn	ひっ
hg	ふっ
ht	へっ
hs	ほっ
mk	まっ
mn	みっ
mg	むっ
mt	めっ
ms	もっ
yk	やっ
yg	ゆっ
ys	よっ
rk	らっ
rn	りっ
rg	るっ
rt	れっ
rs	ろっ
wk	わっ
gk	がっ
gn	ぎっ
gg	ぐっ
gt	げっ
gs	ごっ
zk	ざっ
zn	じっ
zg	ずっ
zt	ぜっ
zs	ぞっ
dk	だっ
dn	ぢっ
dg	づっ
dt	でっ
ds	どっ
bk	ばっ
bn	びっ
bg	ぶっ
bt	べっ
bs	ぼっ
pk	ぱっ
pn	ぴっ
pg	ぷっ
pt	ぺっ
ps	ぽっ
kyk	きゃっ
kyn	きつ
kyg	きゅっ
kyt	きえっ
kys	きょっ
qk	きゃっ
qn	きつ
qg	きゅっ
qt	きえっ
qs	きょっ
gyk	ぎゃっ
gyn	ぎつ
gyg	ぎゅっ
gyt	ぎぇっ
gys	ぎょっ
syk	しゃっ
syn	しつ
syg	しゅっ
syt	しぇっ
sys	しょっ
xk	しゃっ
xn	しつ
xg	しゅっ
xt	しぇっ
xs	しょっ
jk	じゃっ
jn	じつ
jg	じゅっ
jt	じぇっ
js	じょっ
ck	ちゃっ
cn	ちつ
cg	ちゅっ
ct	ちぇっ
cs	ちょっ
dyk	ぢゃっ
dyn	ぢつ
dyg	ぢゅっ
dyt	ぢぇっ
dys	ぢょっ
tsk	つぁっ
tsn	つぃっ
tst	つぇっ
tss	つぉっ
tlk	てゃっ
tln	てぃっ
tlg	てゅっ
tlt	てぇっ
tls	てょっ
dlk	でゃっ
dln	でぃっ
dlg	でゅっ
dlt	でぇっ
dls	でょっ
nyk	にゃっ
nyn	につ
nyg	にゅっ
nyt	にぇっ
nys	にょっ
hyk	ひゃっ
hyn	ひつ
hyg	ひゅっ
hyt	ひぇっ
hys	ひょっ
byk	びゃっ
byn	びつ
byg	びゅっ
byt	びぇっ
bys	びょっ
pyk	ぴゃっ
pyn	ぴつ
pyg	ぴゅっ
pyt	ぴぇっ
pys	ぴょっ
fk	ふぁっ
fn	ふぃっ
fg	ふっ
ft	ふぇっ
fs	ふぉっ
myk	みゃっ
myn	みつ
myg	みゅっ
myt	みぇっ
mys	みょっ
ryk	りゃっ
ryn	りつ
ryg	りゅっ
ryt	りぇっ
rys	りょっ
vz	ゔぁつ
vh	ゔぃつ
vj	ゔつ
vm	ゔぇつ
vb	ゔぉつ
kz	かつ
kh	きつ
kj	くつ
km	けつ
kb	こつ
sz	さつ
sh	しつ
sj	すつ
sm	せつ
sb	そつ
tz	たつ
th	ちつ
tj	つつ
tm	てつ
tb	とつ
nz	なつ
nh	につ
nj	ぬつ
nm	ねつ
nb	のつ
hz	はつ
hh	ひつ
hj	ふつ
hm	へつ
hb	ほつ
mz	まつ
mh	みつ
mj	むつ
mm	めつ
mb	もつ
yz	やつ
yj	ゆつ
yb	よつ
rz	らつ
rh	りつ
rj	るつ
rm	れつ
rb	ろつ
wz	わつ
gz	がつ
gh	ぎつ
gj	ぐつ
gm	げつ
gb	ごつ
zz	ざつ
zh	じつ
zj	ずつ
zm	ぜつ
zb	ぞつ
dz	だつ
dh	ぢつ
dj	づつ
dm	でつ
db	どつ
bz	ばつ
bh	びつ
bj	ぶつ
bm	べつ
bb	ぼつ
pz	ぱつ
ph	ぴつ
pj	ぷつ
pm	ぺつ
pb	ぽつ
kyz	きゃつ
kyh	きち
kyj	きゅつ
kym	きえつ
kyb	きょつ
qz	きゃつ
qh	きち
qj	きゅつ
qm	きえつ
qb	きょつ
gyz	ぎゃつ
gyh	ぎち
gyj	ぎゅつ
gym	ぎぇつ
gyb	ぎょつ
syz	しゃつ
syh	しち
syj	しゅつ
sym	しぇつ
syb	しょつ
xz	しゃつ
xh	しち
xj	しゅつ
xm	しぇつ
xb	しょつ
jz	じゃつ
jh	じち
jj	じゅつ
jm	じぇつ
jb	じょつ
cz	ちゃつ
ch	ちち
cj	ちゅつ
cm	ちぇつ
cb	ちょつ
dyz	ぢゃつ
dyh	ぢち
dyj	ぢゅつ
dym	ぢぇつ
dyb	ぢょつ
tsz	つぁつ
tsh	つぃつ
tsm	つぇつ
tsb	つぉつ
tlz	てゃつ
tlh	てぃつ
tlj	てゅつ
tlm	てぇつ
tlb	てょつ
dlz	でゃつ
dlh	でぃつ
dlj	でゅつ
dlm	でぇつ
dlb	でょつ
nyz	にゃつ
nyh	にち
nyj	にゅつ
nym	にぇつ
nyb	にょつ
hyz	ひゃつ
hyh	ひち
hyj	ひゅつ
hym	ひぇつ
hyb	ひょつ
byz	びゃつ
byh	びち
byj	びゅつ
bym	びぇつ
byb	びょつ
pyz	ぴゃつ
pyh	ぴち
pyj	ぴゅつ
pym	ぴぇつ
pyb	ぴょつ
fz	ふぁつ
fh	ふぃつ
fj	ふつ
fm	ふぇつ
fb	ふぉつ
myz	みゃつ
myh	みち
myj	みゅつ
mym	みぇつ
myb	みょつ
ryz	りゃつ
ryh	りち
ryj	りゅつ
rym	りぇつ
ryb	りょつ
v0	ゔぁく
v7	ゔぃく
v6	ゔく
v8	ゔぇく
v9	ゔぉく
k0	かく
k7	きく
k6	くく
k8	けく
k9	こく
s0	さく
s7	しく
s6	すく
s8	せく
s9	そく
t0	たく
t7	ちく
t6	つく
t8	てく
t9	とく
n0	なく
n7	にく
n6	ぬく
n8	ねく
n9	のく
h0	はく
h7	ひく
h6	ふく
h8	へく
h9	ほく
m0	まく
m7	みく
m6	むく
m8	めく
m9	もく
y0	やく
y6	ゆく
y9	よく
r0	らく
r7	りく
r6	るく
r8	れく
r9	ろく
w0	わく
g0	がく
g7	ぎく
g6	ぐく
g8	げく
g9	ごく
z0	ざく
z7	じく
z6	ずく
z8	ぜく
z9	ぞく
d0	だく
d7	ぢく
d6	づく
d8	でく
d9	どく
b0	ばく
b7	びく
b6	ぶく
b8	べく
b9	ぼく
p0	ぱく
p7	ぴく
p6	ぷく
p8	ぺく
p9	ぽく
ky0	きゃく
ky7	きいく
ky6	きゅく
ky8	きえく
ky9	きょく
q0	きゃく
q7	きいく
q6	きゅく
q8	きえく
q9	きょく
gy0	ぎゃく
gy7	ぎぃく
gy6	ぎゅく
gy8	ぎぇく
gy9	ぎょく
sy0	しゃく
sy7	しいく
sy6	しゅく
sy8	しぇく
sy9	しょく
sr0	しゃく
sr7	しいく
sr6	しゅく
sr8	しぇく
sr9	しょく
x0	しゃく
x7	しいく
x6	しゅく
x8	しぇく
x9	しょく
j0	じゃく
j7	じぃく
j6	じゅく
j8	じぇく
j9	じょく
c0	ちゃく
c7	ちいく
c6	ちゅく
c8	ちぇく
c9	ちょく
dy0	ぢゃく
dy7	ぢぃく
dy6	ぢゅく
dy8	ぢぇく
dy9	ぢょく
ts0	つぁく
ts7	つぃく
ts8	つぇく
ts9	つぉく
tr0	てゃく
tr7	てぃく
tr6	てゅく
tr8	てぇく
tr9	てょく
dr0	でゃく
dr7	でぃく
dr6	でゅく
dr8	でぇく
dr9	でょく
ny0	にゃく
ny7	にぃく
ny6	にゅく
ny8	にぇく
ny9	にょく
hy0	ひゃく
hy7	ひぃく
hy6	ひゅく
hy8	ひぇく
hy9	ひょく
by0	びゃく
by7	びぃく
by6	びゅく
by8	びぇく
by9	びょく
py0	ぴゃく
py7	ぴぃく
py6	ぴゅく
py8	ぴぇく
py9	ぴょく
f0	ふぁく
f7	ふぃく
f6	ふく
f8	ふぇく
f9	ふぉく
my0	みゃく
my7	みぃく
my6	みゅく
my8	みぇく
my9	みょく
ry0	りゃく
ry7	りぃく
ry6	りゅく
ry8	りぇく
ry9	りょく
vr	ゔぃき
vd	ゔぇき
kr	きき
kd	けき
sr	しき
sd	せき
tr	ちき
td	てき
nr	にき
nd	ねき
hr	ひき
hd	へき
mr	みき
md	めき
rr	りき
rd	れき
gr	ぎき
gd	げき
zr	じき
zd	ぜき
dr	ぢき
dd	でき
br	びき
bd	べき
pr	ぴき
pd	ぺき
kyr	きいき
kyd	きえき
qr	きいき
qd	きえき
gyr	ぎぃき
gyd	ぎぇき
syr	しいき
syd	しぇき
srr	しいき
srd	しぇき
xr	しいき
xd	しぇき
jr	じぃき
jd	じぇき
cr	ちいき
cd	ちぇき
dyr	ぢぃき
dyd	ぢぇき
tsr	つぃき
tsd	つぇき
trr	てぃき
trd	てぇき
drr	でぃき
drd	でぇき
nyr	にぃき
nyd	にぇき
hyr	ひぃき
hyd	ひぇき
byr	びぃき
byd	びぇき
pyr	ぴぃき
pyd	ぴぇき
fr	ふぃき
fd	ふぇき
myr	みぃき
myd	みぇき
ryr	りぃき
ryd	りぇき
@1	○
@2	▽
@3	△
@4	□
@5	◇
@6	☆
@7	◎
@8	［
@9	］
@!	●
@"	▼
@#	▲
@$	■
@%	◆
@&	★
@'	‘
@(	【
@)	】
@:	；
@,	，
@.	．
@-	‥
@;	…
@*	×
@<	≦
@>	≧
@=	≠
@+	±
@d	《
@y	》
@D	〈
@Y	〉
@@	“
@[	『
@]	』
@{	〔
@}	〕
@x	※
@c	℃
@l	£
@a	∀
@o	〃
@O	々
@e	€
@g	←
@n	↓
@t	↑
@s	→
@k	↔
@T	〒
@S	⇒
@K	⇔
@/	•
